###################################
#.................................#
#...........##....................#
#.............##..................#
#................##...............#
#....###..##########..............#
#..#............#.........#.......#
#..#............#.........#.......#
#..#............#.........#.......#
#.......######...................##
#..#............#.........#.......#
#..#............#.........#.......#
#...............#.........#.......#
#..#............#.........#.......#
#..#######........................#
#..........###########..####......#
#.................................#
#.................................#
#..............############.......#
#............###..................#
#.........###.....................#
#.................................#
###################################
...................................
...................................
...................................
...................................
...................................
...................................
...................................
...................................
...................................
...................................
...................................
...................................